Aano    :   Aureococcus_anophagefferens_FG.fa    :  Aureococcus anophagefferens  :   eukaryota>stramenopiles
Bden    :   Batrachochytrium_dendrobatidis_FG.fa :  Batrachochytrium dendrobatidis : eukaryota>fungi>chytridiomycota
Bflo    :   Branchiostoma_floridae_FG.fa         :  Branchiostoma floridae       :   eukaryota>metazoa>chordata
Bmal    :   Brugia_malayi_FG.fa                  :  Brugia malayi                :   eukaryota>metazoa>nematode
Caps    :   Capitella_spI_FG.fa                  :  Capitella spI                :   eukaryota>metazoa>annelida
ci      :   Ciona_intestinalis_FG.fa             :  Ciona intestinalis           :   eukaryota>metazoa>chordata
Cmer    :   Cyanidioschyzon_merolae_FG.fa        :  Cyanidioschyzon merolae      :   eukaryota>rhodophyta
Crei    :   Chlamydomonas_reinhardtii_FG.fa      :  Chlamydomonas reinhardtii    :   eukaryota>viridiplantae>chlorophyta
Dpul    :   Daphnia_pulex_FG.fa                  :  Daphnia pulex                :   eukaryota>metazoa>crustacea
Hrob    :   Helobdella_robusta_FG.fa             :  Helobdella robusta           :   eukaryota>metazoa>annelida
Lgig    :   Lottia_gigantea_FG.fa                :  Lottia gigantea              :   eukaryota>metazoa>mollusca
Mbre    :   Monosiga_brevicollis_FG.fa           :  Monosiga brevicollis         :   eukaryota>metazoa>choanoflagellida
Ngru    :   Naegleria_gruberi_FG.fa              :  Naegleria gruberi            :   eukaryota>heterolobosea
Nvec    :   Nematostella_vectensis_FG.fa         :  Nematostella vectensis       :   eukaryota>metazoa>cnidaria
Ppat    :   Physcomitrella_patens_FG.fa          :  Physcomitrella patens        :   eukaryota>viridiplantae
Pram    :   Phytophthora_ramorum_FG.fa           :  Phytophthora ramorum         :   eukaryota>stramenopiles
Psoj    :   Phytophthora_sojae_FG.fa             :  Phytophthora sojae           :   eukaryota>stramenopiles
Ptet    :   Paramecium_tetraurelia_FG.fa         :  Paramecium tetraurelia       :   eukaryota>alveolata>ciliophora
Ptri    :   Phaeodactylum_tricornutum_FG.fa      :  Phaeodactylum tricornutum    :   eukaryota>stramenopiles
Smoe    :   Selaginella_moellendorffii_FG.fa     :  Selaginella moellendorffii   :   eukaryota>viridiplantae
Tadh    :   Trichoplax_adhaerens_FG.fa           :  Trichoplax adhaerens         :   eukaryota>metazoa>placozoa
Tpseu   :   Thalassiosira_pseudonana_FG.fa       :  Thalassiosira pseudonana     :   eukaryota>stramenopiles
Vcar    :   Volvox_carteri_FG.fa                 :  Volvox carteri               :   eukaryota>viridiplantae>chlorophyta
Einv    :   Entamoeba_invadens_FG.fa             :  Entamoeba invadens           :   eukaryota>amoebozoa>entamoebidae
Dpur    :   Dictyostelium_purpureum_FG.fa        :  Dictyostelium purpureum      :   eukaryota>amoebozoa>mycetozoa>dictyosteliida
Mpus    :   Micromonas_pusilla_FG.fa             :  Micromonas pusilla           :   eukaryota>viridiplantae>chlorophyta
Ppla    :   Postia_placenta_FG.fa                :  Postia placenta              :   eukaryota>fungi>basidiomycota
Ehux    :   Emiliania_huxleyi_CCMP1516_FG.fa     :  Emiliania huxleyi            :   eukaryota>haptophyceae
Chlo    :   Chlorella_NC64A_FG.fa                :  Chlorella sp.                :   eukaryota>viridiplantae>chlorophyta
Chet    :   Cochliobolus_heterostrophus_C5_FG.fa :  Cochliobolus heterostrophus  :   eukaryota>fungi>ascomycota
Pbla    :   Phycomyces_blakesleeanus_FG.fa       :  Phycomyces blakesleeanus     :   eukaryota>fungi>basal fungal lineages
Abis    :   Agaricus_bisporus_FG.fa              :  Agaricus bisporus            :   eukaryota>fungi>basidiomycota
Aque    :   Amphimedon_queenslandica_FG.fa       :  Amphimedon queenslandica     :   eukaryota>metazoa>porifera
Fcyl    :   Fragilariopsis_cylindrus_FG.fa       :  Fragilariopsis cylindrus     :   eukaryota>stramenopiles
Mcir    :   Mucor_circinelloides_FG.fa           :  Mucor circinelloides         :   eukaryota>fungi>basal fungal lineages
Odio    :   Oikopleura_dioica_FG.fa              :  Oikopleura dioica            :   eukaryota>metazoa>chordata
Wseb    :   Wallemia_sebi_FG.fa                  :  Wallemia sebi                :   eukaryota>fungi>basidiomycota
Adig    :   Acropora_digitifera_FG.fa            :  Acropora digitifera          :   eukaryota>cnidaria
Bnat    :   Bigelowiella_natans_FG.fa            :  Bigelowiella natans          :   eukaryota>rhizaria>cercozoa
